Ac Ad Ah As
Kc Kd Kh Ks
Qc Qd Qh Qs
Jc Jd Jh Js
10c 10d 10h 10s
9c 9d 9h 9s
8c 8d 8h 8s
7c 7d 7h 7s
6c 6d 6h 6s
5c 5d 5h 5s
4c 4d 4h 4s
3c 3d 3h 3s
2c 2d 2h 2s
